1*1111111111111111111111111111111111
100001000000000000000100000000000001
100000000000000000000100000000000001
100001011100000000000100001000000001
100001000001011111111100001000000001
100001111000000000000100001000000001
100000000000100000000100001000000001
100000000000010000000000001000000001
100000001111111000111100000000000001
100000000000000000000100000000000001
100111111111111000111110000011000001
100000000000000001111100000000001111
100000000111111000001000000000000001
100000000000001000001000000000000001
100000000000001011110000110000000001
100000000000000000001110000000000011
100000000111111010000011000000000011
100000000000100000111110001111100011
100000000011110000000010000000000001
100000000000000000000010000000100011
101000000000011100000010000000000001
101100100000000010000010000000011101
101110000100011111110000111000100001
100000010000000000001111110011010001
1111111111111111111111111111111111#1